25 25
n1nnnnn1n1nnnnn1n1nnnnn1n
1000000010000000100000001
n0000000n0000000n0000000n
n0000000n0000000n0000000n
n000O000n000O000n000O000n
n0000000n0000000n0000000n
n0000000n0000000n0000000n
1000000010000000100000001
n1nnnnn1n1nnnnn1n1nnnnn1n
1000000010000000100000001
n0000000n0000000n0000000n
n0000000n0000000n0000000n
n000O000n000O000n000O000n
n0000000n0000000n0000000n
n0000000n0000000n0000000n
1000000010000000100000001
n1nnnnn1n1nnnnn1n1nnnnn1n
1000000010000000100000001
n0000000n0000000n0000000n
n0000000n0000000n0000000n
n000O000n000O000n000O000n
n0000000n0000000n0000000n
n0000000n0000000n0000000n
1000000010000000100000001
n1nnnnn1n1nnnnn1n1nnnnn1n
