25 25
nlnnnnnlnlnnnnnlnlnnnnnln
l0000000l0000000l0000000l
n0000000n0000000n0000000n
n0000000n0000000n0000000n
n000L000n000L000n000L000n
n0000000n0000000n0000000n
n0000000n0000000n0000000n
l0000000l0000000l0000000l
nlnnnnnlnlnnnnnlnlnnnnnln
l0000000l0000000l0000000l
n0000000n0000000n0000000n
n0000000n0000000n0000000n
n000L000n000L000n000L000n
n0000000n0000000n0000000n
n0000000n0000000n0000000n
l0000000l0000000l0000000l
nlnnnnnlnlnnnnnlnlnnnnnln
l0000000l0000000l0000000l
n0000000n0000000n0000000n
n0000000n0000000n0000000n
n000L000n000L000n000L000n
n0000000n0000000n0000000n
n0000000n0000000n0000000n
l0000000l0000000l0000000l
nlnnnnnlnlnnnnnlnlnnnnnln